# SKIROC CHANNEL | LAYER SENSOR_IX SENSOR_IV IX IV TYPE
	1	0	1	0	0	-3	5	0
	1	2	1	0	0	-2	4	4
	1	4	1	0	0	-3	4	0
	1	6	1	0	0	-4	6	0
	1	8	1	0	0	-3	3	0
	1	10	1	0	0	-5	6	2
	1	12	1	0	0	-4	5	0
	1	14	1	0	0	-2	2	0
	1	16	1	0	0	-2	3	0
	1	18	1	0	0	-1	2	0
	1	20	1	0	0	-1	3	0
	1	22	1	0	0	0	2	0
	1	24	1	0	0	0	1	0
	1	26	1	0	0	1	1	0
	1	28	1	0	0	1	2	0
	1	30	1	0	0	2	2	0
	1	32	1	0	0	2	3	0
	1	34	1	0	0	1	3	0
	1	36	1	0	0	1	4	0
	1	38	1	0	0	0	4	0
	1	40	1	0	0	0	3	0
	1	42	1	0	0	-1	4	0
	1	44	1	0	0	3	3	0
	1	46	1	0	0	-4	7	3
	1	48	1	0	0	2	4	0
	1	50	1	0	0	1	5	2
	1	52	1	0	0	0	5	0
	1	54	1	0	0	-1	5	0
	1	56	1	0	0	-1	6	2
	1	58	1	0	0	-3	6	0
	1	60	1	0	0	-2	5	0
	1	62	1	0	0	-2	6	0
	2	0	1	0	0	5	-2	0
	2	2	1	0	0	6	-2	0
	2	4	1	0	0	6	-3	0
	2	6	1	0	0	5	-1	0
	2	8	1	0	0	5	0	0
	2	10	1	0	0	6	-1	2
	2	12	1	0	0	5	1	2
	2	14	1	0	0	4	0	0
	2	16	1	0	0	4	-1	0
	2	18	1	0	0	3	0	0
	2	20	1	0	0	4	3	3
	2	22	1	0	0	4	2	0
	2	24	1	0	0	4	1	0
	2	26	1	0	0	3	1	0
	2	28	1	0	0	3	2	0
	2	30	1	0	0	2	1	0
	2	32	1	0	0	2	0	0
	2	34	1	0	0	1	0	0
	2	36	1	0	0	1	-1	0
	2	38	1	0	0	2	-1	0
	2	40	1	0	0	4	-4	0
	2	42	1	0	0	3	-3	0
	2	44	1	0	0	4	-3	0
	2	46	1	0	0	5	-5	0
	2	48	1	0	0	6	-5	2
	2	50	1	0	0	5	-4	0
	2	52	1	0	0	3	-2	0
	2	54	1	0	0	3	-1	0
	2	56	1	0	0	4	-2	0
	2	58	1	0	0	5	-3	0
	2	60	1	0	0	7	-4	3
	2	62	1	0	0	6	-4	0
	3	0	1	0	0	1	-4	0
	3	2	1	0	0	2	-4	0
	3	4	1	0	0	2	-5	0
	3	6	1	0	0	2	-6	0
	3	8	1	0	0	4	-5	0
	3	10	1	0	0	3	-6	0
	3	12	1	0	0	3	-7	3
	3	14	1	0	0	4	-6	0
	3	16	1	0	0	5	-6	2
	3	18	1	0	0	3	-5	0
	3	20	1	0	0	3	-4	0
	3	22	1	0	0	2	-3	0
	3	24	1	0	0	1	-3	0
	3	26	1	0	0	1	-2	4
	3	28	1	0	0	2	-2	0
	3	30	1	0	0	0	-3	0
	3	32	1	0	0	-1	-2	0
	3	34	1	0	0	0	-2	0
	3	36	1	0	0	0	0	0
	3	38	1	0	0	0	-1	0
	3	40	1	0	0	-1	-1	0
	3	42	1	0	0	-2	-2	0
	3	44	1	0	0	-1	-3	0
	3	46	1	0	0	-2	-3	0
	3	48	1	0	0	-2	-4	0
	3	50	1	0	0	-1	-4	0
	3	52	1	0	0	-1	-5	2
	3	54	1	0	0	1	-5	0
	3	56	1	0	0	0	-5	0
	3	58	1	0	0	0	-4	0
	3	62	1	0	0	1	-6	2
	4	0	1	0	0	-4	2	0
	4	2	1	0	0	-4	1	0
	4	4	1	0	0	-5	2	0
	4	6	1	0	0	-4	0	0
	4	8	1	0	0	-6	3	0
	4	10	1	0	0	-3	-1	0
	4	12	1	0	0	-4	-1	0
	4	14	1	0	0	-6	4	0
	4	16	1	0	0	-7	4	3
	4	18	1	0	0	-6	2	0
	4	20	1	0	0	-5	1	0
	4	22	1	0	0	-6	1	2
	4	24	1	0	0	-5	0	0
	4	26	1	0	0	-5	-1	2
	4	28	1	0	0	-4	-2	0
	4	30	1	0	0	-3	-2	0
	4	32	1	0	0	-3	-3	0
	4	34	1	0	0	-3	-4	3
	4	36	1	0	0	-1	0	0
	4	38	1	0	0	-2	0	0
	4	40	1	0	0	-2	-1	0
	4	42	1	0	0	-3	0	0
	4	44	1	0	0	-1	1	0
	4	46	1	0	0	-4	3	0
	4	48	1	0	0	-4	4	0
	4	50	1	0	0	-5	5	0
	4	52	1	0	0	-3	2	0
	4	54	1	0	0	-2	1	0
	4	56	1	0	0	-3	1	0
	4	58	1	0	0	-5	3	0
	4	60	1	0	0	-6	5	2
	4	62	1	0	0	-5	4	0
# SKIROC CHANNEL | LAYER SENSOR_IX SENSOR_IV IX IV TYPE
	5	0	2	9	9	3	-5	0
	5	2	2	9	9	2	-4	4
	5	4	2	9	9	3	-4	0
	5	6	2	9	9	4	-6	0
	5	8	2	9	9	3	-3	0
	5	10	2	9	9	5	-6	2
	5	12	2	9	9	4	-5	0
	5	14	2	9	9	2	-2	0
	5	16	2	9	9	2	-3	0
	5	18	2	9	9	1	-2	0
	5	20	2	9	9	1	-3	0
	5	22	2	9	9	0	-2	0
	5	24	2	9	9	0	-1	0
	5	26	2	9	9	-1	-1	0
	5	28	2	9	9	-1	-2	0
	5	30	2	9	9	-2	-2	0
	5	32	2	9	9	-2	-3	0
	5	34	2	9	9	-1	-3	0
	5	36	2	9	9	-1	-4	0
	5	38	2	9	9	0	-4	0
	5	40	2	9	9	0	-3	0
	5	42	2	9	9	1	-4	0
	5	44	2	9	9	-3	-3	0
	5	46	2	9	9	4	-7	3
	5	48	2	9	9	-2	-4	0
	5	50	2	9	9	-1	-5	2
	5	52	2	9	9	0	-5	0
	5	54	2	9	9	1	-5	0
	5	56	2	9	9	1	-6	2
	5	58	2	9	9	3	-6	0
	5	60	2	9	9	2	-5	0
	5	62	2	9	9	2	-6	0
	6	0	2	9	9	-5	2	0
	6	2	2	9	9	-6	2	0
	6	4	2	9	9	-6	3	0
	6	6	2	9	9	-5	1	0
	6	8	2	9	9	-5	0	0
	6	10	2	9	9	-6	1	2
	6	12	2	9	9	-5	-1	2
	6	14	2	9	9	-4	0	0
	6	16	2	9	9	-4	1	0
	6	18	2	9	9	-3	0	0
	6	20	2	9	9	-4	-3	3
	6	22	2	9	9	-4	-2	0
	6	24	2	9	9	-4	-1	0
	6	26	2	9	9	-3	-1	0
	6	28	2	9	9	-3	-2	0
	6	30	2	9	9	-2	-1	0
	6	32	2	9	9	-2	0	0
	6	34	2	9	9	-1	0	0
	6	36	2	9	9	-1	1	0
	6	38	2	9	9	-2	1	0
	6	40	2	9	9	-4	4	0
	6	42	2	9	9	-3	3	0
	6	44	2	9	9	-4	3	0
	6	46	2	9	9	-5	5	0
	6	48	2	9	9	-6	5	2
	6	50	2	9	9	-5	4	0
	6	52	2	9	9	-3	2	0
	6	54	2	9	9	-3	1	0
	6	56	2	9	9	-4	2	0
	6	58	2	9	9	-5	3	0
	6	60	2	9	9	-7	4	3
	6	62	2	9	9	-6	4	0
	7	0	2	9	9	-1	4	0
	7	2	2	9	9	-2	4	0
	7	4	2	9	9	-2	5	0
	7	6	2	9	9	-2	6	0
	7	8	2	9	9	-4	5	0
	7	10	2	9	9	-3	6	0
	7	12	2	9	9	-3	7	3
	7	14	2	9	9	-4	6	0
	7	16	2	9	9	-5	6	2
	7	18	2	9	9	-3	5	0
	7	20	2	9	9	-3	4	0
	7	22	2	9	9	-2	3	0
	7	24	2	9	9	-1	3	0
	7	26	2	9	9	-1	2	4
	7	28	2	9	9	-2	2	0
	7	30	2	9	9	0	3	0
	7	32	2	9	9	1	2	0
	7	34	2	9	9	0	2	0
	7	36	2	9	9	0	0	0
	7	38	2	9	9	0	1	0
	7	40	2	9	9	1	1	0
	7	42	2	9	9	2	2	0
	7	44	2	9	9	1	3	0
	7	46	2	9	9	2	3	0
	7	48	2	9	9	2	4	0
	7	50	2	9	9	1	4	0
	7	52	2	9	9	1	5	2
	7	54	2	9	9	-1	5	0
	7	56	2	9	9	0	5	0
	7	58	2	9	9	0	4	0
	7	62	2	9	9	-1	6	2
	8	0	2	9	9	4	-2	0
	8	2	2	9	9	4	-1	0
	8	4	2	9	9	5	-2	0
	8	6	2	9	9	4	0	0
	8	8	2	9	9	6	-3	0
	8	10	2	9	9	3	1	0
	8	12	2	9	9	4	1	0
	8	14	2	9	9	6	-4	0
	8	16	2	9	9	7	-4	3
	8	18	2	9	9	6	-2	0
	8	20	2	9	9	5	-1	0
	8	22	2	9	9	6	-1	2
	8	24	2	9	9	5	0	0
	8	26	2	9	9	5	1	2
	8	28	2	9	9	4	2	0
	8	30	2	9	9	3	2	0
	8	32	2	9	9	3	3	0
	8	34	2	9	9	3	4	3
	8	36	2	9	9	1	0	0
	8	38	2	9	9	2	0	0
	8	40	2	9	9	2	1	0
	8	42	2	9	9	3	0	0
	8	44	2	9	9	1	-1	0
	8	46	2	9	9	4	-3	0
	8	48	2	9	9	4	-4	0
	8	50	2	9	9	5	-5	0
	8	52	2	9	9	3	-2	0
	8	54	2	9	9	2	-1	0
	8	56	2	9	9	3	-1	0
	8	58	2	9	9	5	-3	0
	8	60	2	9	9	6	-5	2
	8	62	2	9	9	5	-4	0
